%%%%%%%%%%%%%%%%
%o...%....G...%%
%.%%.%.%%%%%%.%%
%..............%
%.%.%%.%%%%%%.%%
%......%%% %...%
%.%.%%.%%%%%%.%%
%..............%
%.%%.%G%%%%%%.%%
%....%...P....%%
%%%%%%%%%%%%%%%%