%%%%%%%%%%%%%%%%
%o...%....G...%%
%.%%.%.%%%%%%.%%
%..............%
%.%.%%.%%..%%.%%
%......%%% %...%
%.%.%%.%%%%%%.%%
%..............%
%.%%.%G%%%%%%.%%
%....%...P....%%
%%%%%%%%%%%%%%%%